#########################
#***********************#
#***********************#
#***********************#
#***********************#
#***********************#
#***********************#
#***********************#
#***********************#
#***********************#
#***********************#
#***********************#
#***********************#
#***********************#
#***********************#
#***********************#
#***********************#
#***********************#
#***********************#
#***********************#
#***********************#
#***********************#
#***********************#
#***********************#
#########################